SO textures/R.xpm
WE textures/R.xpm
C 115,155,155
NO textures/R.xpm

F 255,255,255

EA textures/R.xpm
111111111 
100000001
100000001
100000001
100000001
100000001
111000001
1000N0001
100000001
111111111