SO /nfs/homes/lauger/Documents/PROJECT/five_circle/vox2_cube3d/textures/wall_2.xpm
WE /nfs/homes/lauger/Documents/PROJECT/five_circle/vox2_cube3d/textures/wall_3.xpm
EA /nfs/homes/lauger/Documents/PROJECT/five_circle/vox2_cube3d/textures/wall_4.xpm
NO /nfs/homes/lauger/Documents/PROJECT/five_circle/vox2_cube3d/textures/wall_1.xpm

C 155,155,155
F 255,255,255


111111111 
100000001
100000001
100000001
100000001
100000001
111000001
100000001
100000001
111111111
111111111 
100000001
100000001
100000001
100000001
100000001
111000001
100000001
1000N0001
111111111